-------------------------------------
|   |   |   |   |   |   |   |   |   |
-------------------------------------
|   |   |   |   | M |   |   |   |   |
-------------------------------------
|   |   |   |   | P |   |   |   |   |
-------------------------------------
|   |   |   |   |   |   |   |   |   |
-------------------------------------
|   |   |   |   |   |   |   |   |   |
-------------------------------------
|   |   |   |   |   |   |   |   |   |
-------------------------------------
|   |   |   |   |   |   |   |   |   |
-------------------------------------